urlHelp=help/index.html
lastSaved=上次保存
currentFile=当前文件
toolbar=工具
save=保存
print=打印
cut=剪切
copy=复制
paste=粘贴
delete=删除
undo=撤销
redo=重做
select=选择
connect=连接
pan=手掌
zoomIn=放大
zoomOut=缩小
zoom=缩放
fit=适合
actualSize=实际大小
selectAll=选择所有
clearSelection=清空选择
shape=形状
format=格式化
font=字体
group=分组
ungroup=取消分组
removeFromParent=Orphan
align=对齐
left=居左
right=居右
center=居中
top=顶端对齐
middle=中间对齐
bottom=底部对齐
collapse=椭圆
expand=展开
toBack=移到后面
toFront=移到前面
enterGroup=加入分组
exitGroup=退出分组
layout=布局
horizontalTree=水平树
verticalTree=垂直树
fillColor=填充颜色
strokeColor=画笔颜色
gradientColor=渐变颜色
bold=粗体
italic=斜体
fontColor=文字颜色
fontSize=文字大小
fontFamily=字体
examples=示例
newDiagram=新建
image=图片
opacity=透明度
selection=选择
editStyle=编辑演示
enterStyle=进入样式
enterColorname=进入颜色
enterImageUrl=进入图片URL
enterOpacity=进入透明度(%)
enterFontsize=进入文字大小 (pt)
enterFontfamily=进入字体
toggleRounded=圆形
toggleShadow=阴影
openHref=打开URL
show=显示
exportImage=导出图片
exportSvg=导出SVG
changesLost=所有更改将会丢失！
swimlanes=游泳池
travelBooking=旅游书
notAvailable=不可用
Event=开始
EventEnd=结束
Task=任务
Select=选择
Timer=定时
Message=消息